6,2,7,4,5,8,1,3,9
1,8,9,6,2,3,4,7,5
4,3,5,7,1,9,6,8,2
5,4,6,3,9,7,8,2,1
8,7,2,1,6,5,9,4,3
9,1,3,8,4,2,7,5,6
3,6,1,2,7,4,5,9,8
2,5,4,9,8,6,3,1,7
7,9,8,5,3,1,2,6,4